0 0 5 5 0 0
0 6 5 5 5 0
0 5 5 5 5 0
5 5 5 5 5 5
5 4 5 5 4 5
5 4 5 5 4 5
5 5 5 5 5 5
5 5 5 5 5 5
5 2 2 2 2 5
5 5 5 5 5 5
1 1 1 7 1 1
1 1 1 1 1 1
1 1 1 1 1 1
0 3 0 0 3 0
0 3 0 0 3 0
0 3 0 0 3 0
0 3 0 0 3 0
1 1 0 0 1 1