6 5 5 5 2 0
5 5 2 0 2 0
2 2 2 2 2 2
2 3 2 2 3 2
2 3 3 3 3 2
1 3 2 2 3 1
2 3 1 1 2 1
2 2 1 1 2 2
0 2 3 3 2 0
0 2 3 3 2 0
0 2 2 2 2 0
0 2 2 2 2 0
0 0 2 2 0 0
0 0 2 2 0 0
0 0 0 0 0 0
5 1 5 1 5 1
1 5 1 5 1 5
5 1 5 1 5 1
